11 31
...############################
...........................#..#
#..####..#..#..####..#######..#
#.....#..#..#..#..#...........#
#######..#######..#..#..#..####
#.....#...........#..#..#.....#
#..#######..#..#######..#######
#.....#..#..#..#...........#..#
#..#..#..#..####..####..#..#..#
#s.#...........#..#.....#......
############################..t